111111111
1E0000001
1000C0001
10000P001
111111111