1111111111111
1E00C00000C01
1000011100001
1C000P0000C01
1111111111111