111111111
1E1000001
1000C0001
10000P001
111111111